NO /Users/mtayebi/Desktop/Cub3D/textures/brick1.png
SO /Users/mtayebi/Desktop/Cub3D/textures/brick2.png
WE /Users/mtayebi/Desktop/Cub3D/textures/brick35.png
EA /Users/mtayebi/Desktop/Cub3D/textures/brick4.png

F 185,148,1128
C 135,206,235

1111111111111111111111111
1000000000000000000100001
1001000000000E00000000001
1001000000000000001000001
10010000000000d00001000001
1001000000100000001000001
1001000000000000001000001
1001000000001000001000001
1111111111111111111111111
