NO 	./textures/brick1.png
SO ./textures/brick2.png
WE ./textures/brick4.png
EA ./textures/brick3.png
F 102,51,0

C 				153,255,255

111111111111
1S1
101
101
11